YYYYYYYYYY
RRRRRRRRRR
BBBBBBBBBB
XXXXXXXXXX
GGGGGGGGGG
