RRRRRRRRRR
XXXXXXXXXX
BBBBBBBBBB
GGGGGGGGGG
YYYYYYYYYY